+----------------------------------------------------------------------------------------------------------------------------------------------------------------------------------------------------+
|####################################################################################################################################################################################################|
|####################################################################################################################################################################################################|
|####################################################################################################################################################################################################|
|####################################################################################################################################################################################################|
|####################################################################################################################################################################################################|
|################      ######################    ##########        ##  ######################      ##################  ####      ##################################################      ############|
|################  Ge  ######################      ######                    ######      ####  Ge  ##################  ####  O2  ##############  ##################################  O2  ############|
|################      ####################        ######            ju  Ge          ju  ####      ################              ############      ##            ######      ####        ############|
|##############          ####  ##      ##                                                ######  ##      ########              ############            ju    ju              ####  ju  ##############|
|##############  ju  Ca  ##        Ca  ##    ju                ##    ju                ######        Ca                    ju  ############                                            ##############|
|##############          ##  Ge        ##                  ##  ##            ##        ######              O2                  ##            ju              ju              Ge  ####################|
|##############                  ########      Si      ##      ##                                ju                                Si  ju                                        ####################|
|##############                                                ##                                                                                Ge                  ##  ############################|
|############                                                                                    Ca                                    ##                                    ########################|
|############                        ju                          Si    ju              ju  ju                                ju                          ##                        ##################|
|##########                                                                Ca                                                                                                  ju  ##################|
|##########    ##                                            ##                                            Ge            ####                    ##                    Si            ################|
|############  ##        O2    ######          ######        ##                          Ca                              ##                    ##        ju                          ################|
|################                  ##                ##  ######    ##  ju                                          ju                        ##                      ##  Ge      Ca        ##########|
|################  Ge              ##            Ge                ##                            ju                    ##        O2        ##        ##          ####                  Ge  ##########|
|##########                  O2                      ##  ##          ##            ######              O2  ####        ##                        Ca      Ge    ####            ######      ##########|
|##########  ju                                  ##      ##            ##        ##    ##                        ####  ##      O2                              ##              ######################|
|##########      ######                                  ##            ##          ##                          ####    ##            ju                    ####                ######################|
|######################      ju      O2                  ##    ##          ##                                  ####    ####    Ca                          ##                            ############|
|######################                          ##                ##  ju  ##                                    ##      ##                  ##  ##    ####                    ####  Si  ############|
|################                  Ca                    Ca                            ju  ju              ju                  ##  ju  ju    ##      ####  ##    ##          ######      ############|
|################  Ca    ju                      ##                      ####    ####                  O2          ju                              ####    ########              ####################|
|################                  Ca  ju                            ju    ##  ######                                        ju            Si    ##              ##    ju    ju  ####################|
|########################                                Ca                      ##                                    ju                        ##  Ge          ##              ####################|
|####################      ju        ##                                    Ge          ju                      ##                            ####                  ####      O2            ##########|
|####################  Ca            ##                                                          Si                                          ##    Si            ####              Ge  O2  ##########|
|##################                      ####                ju    ##              Si  ######                  ##                                              ####            ##          ##########|
|##################  ju                  ##                        ##                      ##  ##                    Si                    ##  ju            ####              ######################|
|##################          Ca          ##        ##              ##  O2        ju                Ca                    ####          ju                ######          ##    ######################|
|##############      ####        Ge                              ####                ju      ju              Si          ####      ##              O2    ####            ##  ########################|
|############                        Ca                                                                                          ####                    ##      ju    ####  ######      ############|
|##############                                  ##                                                                          Si  ##                  ju                  ##  ######  O2  ############|
|##############            ####                      Ge                                                                                  Ge                        Si    ##              ############|
|##############  Si  ##  ##                                  Ge              ################          ################      ##  Ge              Ge                                ##################|
|############        ##  ##      Ge                                ##        ##                                      ##                      ##        ju  ju    ##              ####################|
|############  Si  ########                                        ##        ##  Ca                              O2  ##                                          ########      ######################|
|############      ########        ##  ##          Ge      ju      ##        ##                                      ##                                    ########  ##        ######################|
|########################            ##                            ##        ##                                      ##        Ca  ju                                          ######################|
|##############            ju                                                ##                                      ##                                                          ####################|
|##############  O2                        ju                                ##                          @@          ##                                                            ##################|
|##############      ##                                              ##      ##                  ju                  ##                ##          ##                  ju          ##################|
|##############      ##                  ju                                                                                                                ju                      ##################|
|##############      ##      ju                                                                                                          ju                                              ############|
|##############      ##  Si                      ######                                  @@@@    hu        @@                                                      ##                ju  ############|
|##############                          Ca                        Si                                                                                                                    ############|
|##############  ju  ########                    O2                                                                                                                ######          ##################|
|##############                                                              ##                  Ch                  ##                          ##                ####            ##################|
|########################  Si                                                ##          @@                          ##                ju        ##                    ####  O2      ################|
|####################                                                        ##          al  sc  mi  sc  Ch          ##                        ########            Ca                    ############|
|####################  ju    ju                  ju            Si            ##                                      ##                    O2                              Ca              ##########|
|####################                                  Ge                    ##                                      ##                                Si                      ####        ##########|
|################                      ####  Si                              ##  Ge                              Si  ##      Ca            Ca                                        Ca    ##########|
|################            Ca        ##                                    ##                                      ##                                        ju        ##    ju          ##########|
|##############  ##                ##    ##                                  ################          ################                    O2                                              ##########|
|############        ju            ##                                                                                                Ge                                Si                  ##########|
|############  ##        ##        ##                  ####  Si      ##                                                                            ##                            ##        ##########|
|############  ##                    ##    ju                                                                                                                            ju  Ge            ##########|
|##############          ju        ####                  O2                            ##################              Si    O2                Ca    Si        O2                          ##########|
|##############                          ####                ########            Ca                            Ge  Ca                                                        Si    ######  ##########|
|##############                          ####  Ge            ########                                                              ##                                  ##                ############|
|##############            Si                                    ####                                                  Si              O2              ##    ##                    ##################|
|##############  Si                        Si  ##        ##  Ge  ####  ##              ##################    Si  ##                        ##  ##    ####                      Ge  ##################|
|##############            ####                                        ##              ##                              ####                                    ####  O2            ##################|
|################                                      ##              ##    O2                          ju            ####        ##    ##      ##        ju                ju  ####################|
|##############          ########  ##              ##  ####                          ju                                ####  ##              ##    ##                            ####################|
|##############  ju          ##          ##                    ##                          Si  ##      ##              ##            ##      ####                ##              ####################|
|##############        Si                      ##  Ca  O2      ##                      ##              ##              ##                    ##        ju                        ####################|
|####################      ju      ####        ##          Si      ##    Ca                      O2              ##                Si        ####                              ######################|
|####################  Ge      ####          ##                Ca  ##                                              ######                    ##      ##        ju  ##        ########################|
|####################      ##        ju  O2            ##          ##                              ju              ##                    ##  ##  ##                ##            ####      ##########|
|####################                                        ##      ##            ####                              ##          Ge                            O2  ##        ju  ####  ju  ##########|
|################                                          ####  Ca            ju    ##                                                    ####                    ##            ####      ##########|
|################                ####  ##    ##      ####  ##                                          ########    Ca            ##      ##  ##        Ge  ##      ##            ####  ju  ##########|
|##################                                                    Si            Ca                                                          O2                                        ##########|
|##################          O2        ju  ##                                                                                  Si                              O2                ####################|
|##################      ##                ######              ju                                                                                                              ####      ############|
|####################    ####                                                  Ge  ju  ####                                  ##                  ju    ####                Si    ##  ju  ############|
|####################    ##      Ca                              ##                        ##                                            O2  Ge                                  ##      ############|
|############                                                          ju      ju                    ju            O2    ju                            Ge  Ca          Ca                ############|
|############  O2  ##                                    ##    ####                  O2                                                                            Ge          Si    ##    ##########|
|############      ######                                                                                      ##  ju                    Ge  ju                ##                          ##########|
|############  Ca  ######  ju            Si  ####  Ca              Ge                                      ######            ##  Ca  ##                    ##  ######  Ca  ######          ##########|
|############      ######      ##            ####                        Ge                                  ########        ##                              ########      ####          ############|
|####################      ####      Si  ############                ##      ##########        Ca        ############  Ca        ####  ##    ######        ####################  Ca  Ca  ############|
|##################      ######  ju      ######                            ############            ##      ##########        ju  ####  ##  ##########  ##############                    ############|
|####################    ######      ##########  ju  ##            ##  Ca        ######  Ge        ##  ju  ################      ######    ##########  ##############  Si    Ge  ####################|
|##############################################      ##  ##  ju  ####        ju  ######      ########      ##############################  ##########################            ####################|
|##########################################################      ##########      ####################################################################################################################|
|####################################################################################################################################################################################################|
|####################################################################################################################################################################################################|
|####################################################################################################################################################################################################|
|####################################################################################################################################################################################################|
|####################################################################################################################################################################################################|
+----------------------------------------------------------------------------------------------------------------------------------------------------------------------------------------------------+
