type: mettagrid.map_builder.ascii.AsciiMapBuilder.Config
map_data: |-
    ########################################
    #..................................#...#
    #.#.......................#............#
    #.#.........................#....#...#.#
    #..#.........####...................#..#
    #..#...#.....######..........#.........#
    #......#...######.#.......#............#
    #......#...######.##.............##....#
    #....###......####........#....#....#..#
    #............#......................#..#
    #.#####................................#
    #..........S.............+...G#...#....#
    #.....####.............................#
    #........#.............................#
    #........#.....###.....###.............#
    #........#.....#.........#.............#
    #.....#........#....=....#......#......#
    #.....#.........................##.....#
    #.....#.............&....@.......##....#
    #.....#.............@.............#....#
    #.....#.........@.......@..............#
    #.....#.............+..................#
    #..........#...#.........#.......+.....#
    #..........#...#....@....#.............#
    #..........#...###.....###.............#
    #......#...#.................#.........#
    #.....#....#...............+..##.......#
    #.......+..#...................##......#
    #..............#####............##.....#
    #..............#...#......##.....##....#
    #..............#...#.....#.##......#...#
    #....######....#...#....##..##....##...#
    #.........###..#...#....#..O.###.##....#
    #..............#...#....##.....###.....#
    #..............#.........##............#
    #.........................###.....+....#
    #..C........................##.........#
    #...@....@....@........................#
    #......................................#
    ########################################
char_to_map_name:
  "#": wall
  ".": empty
  "O": oxygen_extractor
  "G": germanium_extractor
  "+": junction
  "C": carbon_extractor
  "S": silicon_extractor
  "@": agent.agent
  "&": hub
  "=": chest



