type: mettagrid.map_builder.ascii.AsciiMapBuilder.Config
map_data: |-
    ####################################################################################################################################################
    #......................................................................#..O.#......................................................................#
    #......................................................................#....#......................................................................#
    #......................................................................#....#......................................................................#
    #......................................................................#....#......................................................................#
    #......................................................................#....#......................................................................#
    #......................................................................#....#......................................................................#
    #......................................................................#....#......................................................................#
    #......................................................................#....#......................................................................#
    #......................................................................#....#......................................................................#
    #......................................................................#....#......................................................................#
    #......................................................................#....#......................................................................#
    #......................................................................#....+......................................................................#
    #......................................................................#....#......................................................................#
    #......................................................................#....#......................................................................#
    #......................................................................#....#......................................................................#
    #......................................................................#....#......................................................................#
    #......................................................................#....#......................................................................#
    #......................................................................#....#......................................................................#
    #......................................................................#....#......................................................................#
    #......................................................................#....#......................................................................#
    #......................................................................#....#......................................................................#
    #......................................................................#....#......................................................................#
    #......................................................................#....#......................................................................#
    #......................................................................#....#......................................................................#
    #......................................................................#....#......................................................................#
    #......................................................................#....#......................................................................#
    #......................................................................#....#......................................................................#
    #......................................................................#....#......................................................................#
    #......................................................................#....#......................................................................#
    #......................................................................#....#......................................................................#
    #......................................................................#....#......................................................................#
    #......................................................................#....#......................................................................#
    #......................................................................+....#......................................................................#
    #......................................................................#....#......................................................................#
    #......................................................................#....#......................................................................#
    #......................................................................#....#......................................................................#
    #......................................................................#....#......................................................................#
    #......................................................................#....#......................................................................#
    #......................................................................#....#......................................................................#
    #......................................................................#....#......................................................................#
    #......................................................................#....#......................................................................#
    #......................................................................#....#......................................................................#
    #......................................................................#....#......................................................................#
    #......................................................................#....#......................................................................#
    #......................................................................#....#......................................................................#
    #......................................................................#....+......................................................................#
    #......................................................................#....#......................................................................#
    #......................................................................#....#......................................................................#
    #......................................................................#....#......................................................................#
    #......................................................................#....#......................................................................#
    #......................................................................#....#......................................................................#
    #......................................................................#....#......................................................................#
    #......................................................................#....#......................................................................#
    #......................................................................#....#......................................................................#
    #......................................................................#....#......................................................................#
    #......................................................................#....#......................................................................#
    #......................................................................#....#......................................................................#
    #......................................................................#....#......................................................................#
    #......................................................................#....#......................................................................#
    #......................................................................+....+......................................................................#
    #......................................................................+....+......................................................................#
    ########################################################################....########################################################################
    #.........+........................................................................................+...............................................#
    #.......................................................................@..........................................................................#
    #G.................................................................@..@.&....@....................................................................C#
    #......................................................................@.=.................................................+.......................#
    #...........................+......................................................................................................................#
    #########################.............................................................##############################################################
    ########################################################################....########################################################################
    #......................................................................#....#......................................................................#
    #......................................................................#....#......................................................................#
    #......................................................................#....#......................................................................#
    #......................................................................#....#......................................................................#
    #......................................................................#....#......................................................................#
    #......................................................................#....#......................................................................#
    #......................................................................#....#......................................................................#
    #......................................................................#....#......................................................................#
    #......................................................................#....#......................................................................#
    #......................................................................#....#......................................................................#
    #......................................................................#....#......................................................................#
    #......................................................................#....#......................................................................#
    #......................................................................#....#......................................................................#
    #......................................................................#....+......................................................................#
    #......................................................................#....#......................................................................#
    #......................................................................#....#......................................................................#
    #......................................................................#....#......................................................................#
    #......................................................................#....#......................................................................#
    #......................................................................#....#......................................................................#
    #......................................................................#....#......................................................................#
    #......................................................................#....#......................................................................#
    #......................................................................#....#......................................................................#
    #......................................................................#....#......................................................................#
    #......................................................................#....#......................................................................#
    #......................................................................#....#......................................................................#
    #......................................................................#....#......................................................................#
    #......................................................................+....#......................................................................#
    #......................................................................#....#......................................................................#
    #......................................................................#....#......................................................................#
    #......................................................................#....#......................................................................#
    #......................................................................#....#......................................................................#
    #......................................................................#....#......................................................................#
    #......................................................................#....#......................................................................#
    #......................................................................#....#......................................................................#
    #......................................................................#....#......................................................................#
    #......................................................................#....#......................................................................#
    #......................................................................#....#......................................................................#
    #......................................................................#....#......................................................................#
    #......................................................................#....#......................................................................#
    #......................................................................#....#......................................................................#
    #......................................................................#....#......................................................................#
    #......................................................................#....#......................................................................#
    #......................................................................#....#......................................................................#
    #......................................................................#....#......................................................................#
    #......................................................................#....#......................................................................#
    #......................................................................#....+......................................................................#
    #......................................................................#....#......................................................................#
    #......................................................................#....#......................................................................#
    #......................................................................#....#......................................................................#
    #......................................................................#....#......................................................................#
    #......................................................................#....#......................................................................#
    #......................................................................#....#......................................................................#
    #......................................................................#....#......................................................................#
    #......................................................................#....#......................................................................#
    #......................................................................#....#......................................................................#
    #......................................................................#....#......................................................................#
    #......................................................................#....#......................................................................#
    #......................................................................#....#......................................................................#
    #......................................................................#....#......................................................................#
    #......................................................................#....#......................................................................#
    #......................................................................#....#......................................................................#
    #......................................................................#....#......................................................................#
    #......................................................................#....#......................................................................#
    #......................................................................+....#......................................................................#
    #......................................................................#....#......................................................................#
    #......................................................................#....#......................................................................#
    #......................................................................#....#......................................................................#
    #......................................................................#....#......................................................................#
    #......................................................................#....#......................................................................#
    #......................................................................#....#......................................................................#
    #......................................................................#....#......................................................................#
    #......................................................................#....#......................................................................#
    #......................................................................#....#......................................................................#
    #......................................................................#....#......................................................................#
    #......................................................................#....#......................................................................#
    #......................................................................#....+......................................................................#
    #......................................................................#....#......................................................................#
    #......................................................................#....#......................................................................#
    #......................................................................#....#......................................................................#
    #......................................................................#....#......................................................................#
    #......................................................................#....#......................................................................#
    #......................................................................#....#......................................................................#
    #......................................................................#....#......................................................................#
    #......................................................................#....#......................................................................#
    #......................................................................#....#......................................................................#
    #......................................................................#....#......................................................................#
    #......................................................................#..S.#......................................................................#
    ####################################################################################################################################################
char_to_map_name:
  "#": wall
  ".": empty
  "+": junction
  "G": germanium_extractor
  "C": carbon_extractor
  "S": silicon_extractor
  "O": oxygen_extractor
  "&": hub
  "=": chest
  "@": agent.agent
  "1": agent.agent
  "2": agent.agent
  "3": agent.agent
  "4": agent.agent



