type: mettagrid.map_builder.ascii.AsciiMapBuilder.Config
map_data: |-
  #######################
  #.....................#
  #......########.......#
  #......#...S..#.......#
  #......#.@....#.......#
  #......#......#.......#
  #......#......#.......#
  #......########.......#
  #.....................#
  #........._...........#
  #.....................#
  #######################
char_to_map_name:
  "#": wall
  ".": empty
  "S": lasery
  "@": agent.agent
  "_": hub
