type: mettagrid.map_builder.ascii.AsciiMapBuilder.Config
map_data: |-
  ########################################
  #.#####..@..._.........................#
  #.....#.....#.....#.....##...###...#...#
  #.####...........................#####.#
  #.....#.....#.....#.....#.....#........#
  #.####.#........###.#..........#####...#
  #.....#.....#.....#.....#.....#........#
  #.#####.#####.......#####.##.........###
  #.....#.....#.....#.....#.....#........#
  #.######.#......######.######.##..######
  #.....#............#.....#.............#
  #...#.....#...#.....#...#..............#
  #.#.###..m...###.#.#...................#
  #.#...........#.#.#.....#...........#.##
  #.#####....#.###.###.#........##.#####.#
  #.....#.....#.....#...#.............#..#
  #.###.###......######............##.####
  #...#...#.....#.........#...#...#.....##
  #.###.######....###.#######.........####
  #...#.....#.....#...#.....#............#
  #......................................#
  #.....#.....#.....#...#.....#.....#....#
  #.#####..........##.#####.##..........##
  #.....#.....#.....#.....#.....#.....#..#
  #.######.######.######.................#
  #.....#.....#.....#.....#.....#.....#..#
  #.####.#........###.#......n...###.....#
  #.....#.....#.....#.....#.....#.....#..#
  ########################################
char_to_map_name:
  "#": wall
  ".": empty
  "@": agent.agent
  "_": hub
  "m": mine_red
  "n": generator_red
