type: mettagrid.map_builder.ascii.AsciiMapBuilder.Config
map_data: |-
  ############################
  #..........................#
  #...@......................#
  #.............######.......#
  #.............#.n..........#
  #.............#............#
  #.............#............#
  #.............#............#
  #.####.....................#
  #....#.....................#
  #.._.#.....................#
  #..........................#
  #..........................#
  #..........................#
  #..........................#
  #..........................#
  #..........................#
  #........#####..###........#
  #........#...m....#........#
  #...........#..............#
  #..........................#
  #..........................#
  ############################
char_to_map_name:
  "#": wall
  ".": empty
  "@": agent.agent
  "n": generator_red
  "_": hub
  "m": mine_red
