type: mettagrid.map_builder.ascii.AsciiMapBuilder.Config
map_data: |-
  #################################
  #...............................#
  #..........................@....#
  #...............................#
  #...............................#
  #.....###########################
  #.....#.n....#...#...........m..#
  #.....#......#...#..............#
  #.....#......#...#..............#
  #.....#......#...#..............#
  #_....#......#...#..............#
  #.....#......#...#..............#
  #.....#......#...#..............#
  #.....#......#...#..............#
  #.....#......#...#..............#
  #.....#......#...#..............#
  #.....#......#...#..............#
  #.....#......#...#..............#
  #.....#......#...#..............#
  #.#####......#####..............#
  #...............................#
  #...............................#
  #...............................#
  #...............................#
  #################################
char_to_map_name:
  "#": wall
  ".": empty
  "@": agent.agent
  "n": generator_red
  "m": mine_red
  "_": hub
