type: mettagrid.map_builder.ascii.AsciiMapBuilder.Config
map_data: |-
  ##############
  ##############
  ##############
  ##############
  ##############
  ##...........#
  ##...........#
  ##...........#
  ##...#...#...#
  ##...#...#...#
  ##...#...#...#
  ##...#...#...#
  ##...#...#...#
  ##...#...#...#
  ##.n.#.@_#m..#
  ##############
  ##############
  ##############
  ##############
  ##############
  ##...........#
  ##...........#
  ##...........#
  ##...#...#...#
  ##...#...#...#
  ##...#...#...#
  ##...#...#...#
  ##...#...#...#
  ##...#...#...#
  ##...#...#...#
  ##..m#_@.#n..#
  ##############
  ##############
  ##############
char_to_map_name:
  "#": wall
  ".": empty
  "n": generator_red
  "@": agent.agent
  "_": hub
  "m": mine_red
