type: mettagrid.map_builder.ascii.AsciiMapBuilder.Config
map_data: |-
  ############################
  #..........................#
  #...@._....................#
  ###############............#
  #..........................#
  #..n.......................#
  ###############............#
  #.............#............#
  #.......##############.....#
  #.............#............#
  #.............#............#
  #.............#............#
  #.............#............#
  #..........................#
  #..........................#
  #..........................#
  #..........................#
  #......############........#
  #..........................#
  #..........................#
  #.............#............#
  #.............#............#
  #########..........#########
  #..........................#
  #..........................#
  #..........................#
  #.......m.....#............#
  #.............#............#
  #.............#............#
  #.............#............#
  #.............#............#
  ############################
char_to_map_name:
  "#": wall
  ".": empty
  "@": agent.agent
  "_": hub
  "n": generator_red
  "m": mine_red
