type: mettagrid.map_builder.ascii.AsciiMapBuilder.Config
map_data: |-
  #########################
  #n......................#
  #.......................#
  #.......................#
  #...#....#....#....#....#
  #...#....#....#....#....#
  #...#....#....#....#....#
  #...#....#....#....#....#
  #...#....#....#....#....#
  #...#....#....#....#....#
  #...#....#....#....#....#
  #...#.._.#..@.#....#.m..#
  #########################
  #########################
  #########################
  #########################
char_to_map_name:
  "#": wall
  "n": generator_red
  ".": empty
  "_": hub
  "@": agent.agent
  "m": mine_red
