type: mettagrid.map_builder.ascii.AsciiMapBuilder.Config
map_data: |-
  ########################################################################################
  ###...........########################.......###########################################
  ######............####################..n....###########################################
  ######............###################........###########################################
  #########............#################.......#######################...........#########
  ###########...........################.......####################.............##########
  ############...........###############.......################..............#############
  #############............############.......#############..............#################
  ################...........###########.......###########...........#####################
  ##################...........#########.......#########...........#######################
  ####################...........#######.......#######...........#########################
  ######################...........#####.......######.........############################
  ########################..........####.......####........###############################
  ##########################..........##.......##.........################################
  #############################...........................################################
  #......................................................................................#
  #.....................................@................................................#
  #......................................................................................#
  #......................................................................................#
  ############################.........................###################################
  ##########################..............................################################
  ########################..........####.......###........################################
  #####################...........######.......####...........############################
  #####################...........#######.......######.........###########################
  ####################.........#########.......########...........########################
  ##################.........##########........###########...........#####################
  ################.........#############.......##############..........###################
  ##############.........###############.......#################...........###############
  ###########.....m.....#################.......###################...........############
  ######..............##################.......######################....._....###########
  ########################################################################################
char_to_map_name:
  "#": wall
  ".": empty
  "n": generator_red
  "@": agent.agent
  "m": mine_red
  "_": hub
